#####
#S..#
#.#.#
#M.E#
#####
