#########
#S#.#.#.#
#*#.#.#.#
#..*....#
#.#######
#.#M....#
#.#.#####
#......E#
#########
